10 10
BBBWWWBBBB
BFBBBWBBBB
BBBBBBBBBB
BBBBBWBBBB
BBBBWWBBBB
BBBBBBBBBB
BBWBBBBWBB
BBWWBBBWBB
BBBBBBBWBB
BBBBBBBBBB