20 20
BBBWWWBBBBBBBWWWBBBB
BBBBBWBBBBBBBBBWBBBB
BBBBBBBBBBBBBBBBBBBB
BBBBBWBBBBBBBBBWBBBB
BBBBWWBBBBBBBBWWBBBB
BBBBBBBBBBBBBBBBBBBB
BBWBBBBWBBBBWBBBBWBB
BBWWBBBWBBBBWWBBBWBB
BBBBBBBWBBBBBBBBBWBB
BBBBBBBBBBBBBBBBBBBB
BBBWWWBBBBBBBWWWBBBB
BBBBBWBBBBBFBBBWBBBB
BBBBBBBBBBBBBBBBBBBB
BBBBBWBBBBBBBBBWBBBB
BBBBWWBBBBBBBBWWBBBB
BBBBBBBBBBBBBBBBBBBB
BBWBBBBWBBBBWBBBBWBB
BBWWBBBWBBBBWWBBBWBB
BBBBBBBWBBBBBBBBBWBB
BBBBBBBBBBBBBBBBBBBB