################################################################################
#..............................................................................#
#..............................................................................#
#..............................................................................#
#..............................................................................#
#..............................................................................#
#..............................................................................#
#..............................................................................#
#..............................................................................#
#................................#############.................................#
#................................#...........#.................................#
#................................#...........#.................................#
#................................#...........#.................................#
#................................#......0....#.................................#
#................................#...........#.................................#
#................................#...........#.................................#
#................................#...........#.................................#
#................................####....#####.................................#
#...................................#....#.....................................#
#..............................................................................#
#..............................................................................#
#..............................................................................#
#..............................................................................#
#..............................................................................#
#..............................................................................#
#............................####################..............................#
#..............................................................................#
#..............................................................................#
#..............................................................................#
#..............................................................................#
#..............................................................................#
#..............................................................................#
#..............................................................................#
#..............................................................................#
#..............................................................................#
#..............................................................................#
#..............................................................................#
###############################................................................#
#..............................................................................#
#..............................................................................#
#..............................................................................#
#..............................................................................#
#..............................................................................#
#..........................................#####################################
#..............................................................................#
#..............................................................................#
#..............................................................................#
#..............................................................................#
#......................................................#.......................#
#......................................................#.......................#
#....................###########################.......#.......................#
#......................................................#.......................#
#......................................................#.......................#
#......................................................#.......................#
#......................................................#.......................#
#......................................................#.......................#
#......................................................#.......................#
#......................................................#.......................#
#......................................................#.......................#
#################################......................#.......................#
#......................................................#.......................#
#......................................................#.......................#
#......................................................#.......................#
#......................................................#.......................#
#......................................................#.......................#
#......................................................#.......................#
#......................................................#.......................#
#......................................................#.......................#
#......................................................#.......................#
#......................................................#.......................#
#....................#.........#.......................#.......................#
#....................#.........#.......................#.......................#
#....................#.........#.......................#.......................#
#....................#.........#.......................#.......................#
#....................#.........#.......................#.......................#
#....................#.....*...#.......................#.......................#
#....................#.........#...............................................#
#....................#.........#...............................................#
#....................#.........#...............................................#
################################################################################
10