map-size:;10;10
W;W;S;S;S;W;W;S;S;S;
S;W;W;W;S;S;S;S;G;S;
S;S;S;S;S;S;W;S;S;S;
W;W;W;W;W;S;W;W;S;W;
S;S;S;S;W;S;S;S;S;W;
W;W;S;S;W;S;S;W;W;W;
S;W;S;S;S;S;S;S;S;S;
S;S;S;W;S;W;W;S;S;S;
S;W;S;W;S;S;W;W;W;S;
S;S;S;W;W;S;S;S;W;W;
