################################################################################
#..............................................................................#
#..............................................................................#
#................................................#.............................#
#................................................#.............................#
#................................................#.............................#
#................................................#.............................#
#................................................#.............................#
#................................................#.............................#
#................................................#.............................#
#................................................#.............................#
#..............................................................................#
#.....................................................................0........#
#.........#######################..............................................#
#..............................................................................#
#..............................................................................#
#..........................................................#####################
#..............................................................................#
#..............................................................................#
#................................................#.............................#
#................................................#.............................#
#................................................#...................#.........#
#................................................#...................#.........#
#................................................#...................#.........#
#................................................#...................#.........#
#................................................#...................#.........#
#................................................#...................#.........#
#................................................#...................#.........#
##########################################.......#...................#.........#
#................................................#...................#.........#
#................................................#...................#.........#
#................................................#...................#.........#
#................................................#...................#.........#
#................................................#...................#.........#
#................................................#...................#.........#
#................................................#...................#.........#
#................................................#...................#.........#
#................................................#...................#.........#
#................................................#...................#.........#
#..............................................................................#
#..............................................................................#
#..............................................................................#
#..............................................................................#
#..............................................................................#
#..............................................................................#
#..............................................................................#
#################...............##################.............#################
#..............................................................................#
#..............................................................................#
#..............................................................................#
#..............................................................................#
#.......................................................#......................#
#.......................................................#......................#
#.......................................................#......................#
#.......................................................#......................#
#.......................................................#......................#
#.......................................................#......................#
#........................................#..............#......................#
#........................................#..............#......................#
#........................................#..............#......................#
#........................................#..............#......................#
#........................................#..............#......................#
#........................................#..............#......................#
#........................................#..............#......................#
####################.....................#..............#......................#
#........................................#..............#......................#
#........................................#..............#......................#
#........................................#..............#......................#
#........................................#..............#......................#
#........................................#..............#......................#
#........................................#..............#......................#
#........................................#..............#......................#
#..........*.............................#..............#......................#
#.......................................................#......................#
#.......................................................#......................#
#.......................................................#......................#
#..............................................................................#
#..............................................................................#
#..............................................................................#
################################################################################
10.8001
80 80